1111111111111111111
100C000000000000001
1P00000000000000001
10000E0000000000001
1000000C00000000001
1000000000000011111
1111111111111111111
