11111111111111111111111
11111100000000010000011
11100000C11111000000001
10000000000000000000001
10000000000000000000011
1111P000000000000000001
10000000000000000000001
10000000000E11111000001
11111111111111111111111