111111111111111
100C00000000001
1000000C0000P01
11100E0000CC001
111100000111111
100000000000011
100000000000001
111111111111111
