111111111111111
100C00000000001
10000000C000P01
10000000E000001
111110000000C01
111111111111111