11111111111
11111111111
11111PCE011
11111111111
11111111111