11111111111111111
10000000000000011
10000000C00000001
10000000000000001
10000000000000001
1000P000000000001
10000000000000001
10000000000E00001
11111111111111111