11111111111111111
11111111111111111
1P000000000000001
10000000000000001
1C0000000C00000C1
10000001111111111
10000000000000001
1111C0000000C1111
100000E0000001111
11111111111111111